BBBBBBBBBBBB
B...B.....CB
B.B.B.B.B.BB
B.......B..B
B.B.BB.BB.BB
B.B....B...B
B.RBBBB..BBB
BBBBBBBXBBBB